gene	cluster
NLGN4X	Genes_SelectbyRFEofFeatureData_expr_label_cluster 1 .txt
DACH1	Genes_SelectbyRFEofFeatureData_expr_label_cluster 10 .txt
REST	Genes_SelectbyRFEofFeatureData_expr_label_cluster 10 .txt
KTN1	Genes_SelectbyRFEofFeatureData_expr_label_cluster 10 .txt
CHMP1A	Genes_SelectbyRFEofFeatureData_expr_label_cluster 10 .txt
TP53BP2	Genes_SelectbyRFEofFeatureData_expr_label_cluster 10 .txt
CREBZF	Genes_SelectbyRFEofFeatureData_expr_label_cluster 10 .txt
BEX3	Genes_SelectbyRFEofFeatureData_expr_label_cluster 10 .txt
RFX5	Genes_SelectbyRFEofFeatureData_expr_label_cluster 10 .txt
VPS4B	Genes_SelectbyRFEofFeatureData_expr_label_cluster 10 .txt
RCOR1	Genes_SelectbyRFEofFeatureData_expr_label_cluster 10 .txt
MXI1	Genes_SelectbyRFEofFeatureData_expr_label_cluster 10 .txt
FBXO4	Genes_SelectbyRFEofFeatureData_expr_label_cluster 10 .txt
SAP30L	Genes_SelectbyRFEofFeatureData_expr_label_cluster 10 .txt
YAP1	Genes_SelectbyRFEofFeatureData_expr_label_cluster 10 .txt
NCOR1	Genes_SelectbyRFEofFeatureData_expr_label_cluster 10 .txt
KIF5B	Genes_SelectbyRFEofFeatureData_expr_label_cluster 10 .txt
KIF5A	Genes_SelectbyRFEofFeatureData_expr_label_cluster 10 .txt
HAUS6	Genes_SelectbyRFEofFeatureData_expr_label_cluster 11 .txt
KIF2B	Genes_SelectbyRFEofFeatureData_expr_label_cluster 11 .txt
RAB10	Genes_SelectbyRFEofFeatureData_expr_label_cluster 11 .txt
TPX2	Genes_SelectbyRFEofFeatureData_expr_label_cluster 11 .txt
GSPT1	Genes_SelectbyRFEofFeatureData_expr_label_cluster 12 .txt
RPS6	Genes_SelectbyRFEofFeatureData_expr_label_cluster 12 .txt
CRYZ	Genes_SelectbyRFEofFeatureData_expr_label_cluster 12 .txt
GCLM	Genes_SelectbyRFEofFeatureData_expr_label_cluster 12 .txt
DDX56	Genes_SelectbyRFEofFeatureData_expr_label_cluster 12 .txt
RTCA	Genes_SelectbyRFEofFeatureData_expr_label_cluster 12 .txt
EIF4G1	Genes_SelectbyRFEofFeatureData_expr_label_cluster 12 .txt
SKIV2L	Genes_SelectbyRFEofFeatureData_expr_label_cluster 12 .txt
UPF3A	Genes_SelectbyRFEofFeatureData_expr_label_cluster 12 .txt
PDCD5	Genes_SelectbyRFEofFeatureData_expr_label_cluster 12 .txt
EIF1AX	Genes_SelectbyRFEofFeatureData_expr_label_cluster 12 .txt
DCAF4	Genes_SelectbyRFEofFeatureData_expr_label_cluster 13 .txt
POLD3	Genes_SelectbyRFEofFeatureData_expr_label_cluster 13 .txt
REV1	Genes_SelectbyRFEofFeatureData_expr_label_cluster 13 .txt
CUL4A	Genes_SelectbyRFEofFeatureData_expr_label_cluster 13 .txt
SF3B1	Genes_SelectbyRFEofFeatureData_expr_label_cluster 13 .txt
TAF1A	Genes_SelectbyRFEofFeatureData_expr_label_cluster 13 .txt
TUBA8	Genes_SelectbyRFEofFeatureData_expr_label_cluster 13 .txt
GTF2E2	Genes_SelectbyRFEofFeatureData_expr_label_cluster 13 .txt
ELAVL2	Genes_SelectbyRFEofFeatureData_expr_label_cluster 13 .txt
MSH4	Genes_SelectbyRFEofFeatureData_expr_label_cluster 14 .txt
RMI1	Genes_SelectbyRFEofFeatureData_expr_label_cluster 14 .txt
LMO4	Genes_SelectbyRFEofFeatureData_expr_label_cluster 14 .txt
SH3GL2	Genes_SelectbyRFEofFeatureData_expr_label_cluster 15 .txt
LEPROT	Genes_SelectbyRFEofFeatureData_expr_label_cluster 15 .txt
SH3GL3	Genes_SelectbyRFEofFeatureData_expr_label_cluster 15 .txt
ATF7IP	Genes_SelectbyRFEofFeatureData_expr_label_cluster 15 .txt
ADAM12	Genes_SelectbyRFEofFeatureData_expr_label_cluster 15 .txt
PPFIA2	Genes_SelectbyRFEofFeatureData_expr_label_cluster 16 .txt
TMF1	Genes_SelectbyRFEofFeatureData_expr_label_cluster 16 .txt
FER	Genes_SelectbyRFEofFeatureData_expr_label_cluster 16 .txt
RAB6B	Genes_SelectbyRFEofFeatureData_expr_label_cluster 16 .txt
UNC13B	Genes_SelectbyRFEofFeatureData_expr_label_cluster 16 .txt
COG5	Genes_SelectbyRFEofFeatureData_expr_label_cluster 16 .txt
SVIL	Genes_SelectbyRFEofFeatureData_expr_label_cluster 17 .txt
HAP1	Genes_SelectbyRFEofFeatureData_expr_label_cluster 17 .txt
PTCD3	Genes_SelectbyRFEofFeatureData_expr_label_cluster 17 .txt
NAP1L5	Genes_SelectbyRFEofFeatureData_expr_label_cluster 17 .txt
LUC7L2	Genes_SelectbyRFEofFeatureData_expr_label_cluster 17 .txt
MRPS21	Genes_SelectbyRFEofFeatureData_expr_label_cluster 17 .txt
MRPL32	Genes_SelectbyRFEofFeatureData_expr_label_cluster 17 .txt
MRPL4	Genes_SelectbyRFEofFeatureData_expr_label_cluster 17 .txt
MRPL55	Genes_SelectbyRFEofFeatureData_expr_label_cluster 17 .txt
HIST1H2AA	Genes_SelectbyRFEofFeatureData_expr_label_cluster 18 .txt
HIST1H3I	Genes_SelectbyRFEofFeatureData_expr_label_cluster 18 .txt
HIST1H3J	Genes_SelectbyRFEofFeatureData_expr_label_cluster 18 .txt
HERC2	Genes_SelectbyRFEofFeatureData_expr_label_cluster 18 .txt
BMP2	Genes_SelectbyRFEofFeatureData_expr_label_cluster 19 .txt
CD1D	Genes_SelectbyRFEofFeatureData_expr_label_cluster 19 .txt
CHRD	Genes_SelectbyRFEofFeatureData_expr_label_cluster 19 .txt
COL2A1	Genes_SelectbyRFEofFeatureData_expr_label_cluster 19 .txt
ANXA5	Genes_SelectbyRFEofFeatureData_expr_label_cluster 19 .txt
IFNGR2	Genes_SelectbyRFEofFeatureData_expr_label_cluster 19 .txt
COL5A1	Genes_SelectbyRFEofFeatureData_expr_label_cluster 19 .txt
SPARC	Genes_SelectbyRFEofFeatureData_expr_label_cluster 19 .txt
HLA.DMB	Genes_SelectbyRFEofFeatureData_expr_label_cluster 19 .txt
TNFRSF8	Genes_SelectbyRFEofFeatureData_expr_label_cluster 2 .txt
HSBP1	Genes_SelectbyRFEofFeatureData_expr_label_cluster 2 .txt
TRIB3	Genes_SelectbyRFEofFeatureData_expr_label_cluster 2 .txt
HIST1H4D	Genes_SelectbyRFEofFeatureData_expr_label_cluster 2 .txt
TOMM34	Genes_SelectbyRFEofFeatureData_expr_label_cluster 2 .txt
EIF2AK3	Genes_SelectbyRFEofFeatureData_expr_label_cluster 2 .txt
CRY1	Genes_SelectbyRFEofFeatureData_expr_label_cluster 2 .txt
NR5A1	Genes_SelectbyRFEofFeatureData_expr_label_cluster 2 .txt
CDC37	Genes_SelectbyRFEofFeatureData_expr_label_cluster 2 .txt
ZFAND5	Genes_SelectbyRFEofFeatureData_expr_label_cluster 2 .txt
MARK2	Genes_SelectbyRFEofFeatureData_expr_label_cluster 2 .txt
ERBB2	Genes_SelectbyRFEofFeatureData_expr_label_cluster 2 .txt
CRTC2	Genes_SelectbyRFEofFeatureData_expr_label_cluster 2 .txt
HSPA1L	Genes_SelectbyRFEofFeatureData_expr_label_cluster 2 .txt
CAD	Genes_SelectbyRFEofFeatureData_expr_label_cluster 2 .txt
CHRM4	Genes_SelectbyRFEofFeatureData_expr_label_cluster 2 .txt
CNTN2	Genes_SelectbyRFEofFeatureData_expr_label_cluster 2 .txt
YBX3	Genes_SelectbyRFEofFeatureData_expr_label_cluster 2 .txt
NPAS2	Genes_SelectbyRFEofFeatureData_expr_label_cluster 2 .txt
BID	Genes_SelectbyRFEofFeatureData_expr_label_cluster 2 .txt
NFKB2	Genes_SelectbyRFEofFeatureData_expr_label_cluster 2 .txt
HSF1	Genes_SelectbyRFEofFeatureData_expr_label_cluster 2 .txt
CASP14	Genes_SelectbyRFEofFeatureData_expr_label_cluster 2 .txt
ARID3A	Genes_SelectbyRFEofFeatureData_expr_label_cluster 2 .txt
AKT2	Genes_SelectbyRFEofFeatureData_expr_label_cluster 2 .txt
SUB1	Genes_SelectbyRFEofFeatureData_expr_label_cluster 2 .txt
CRHR1	Genes_SelectbyRFEofFeatureData_expr_label_cluster 20 .txt
CNR1	Genes_SelectbyRFEofFeatureData_expr_label_cluster 20 .txt
PLCB3	Genes_SelectbyRFEofFeatureData_expr_label_cluster 20 .txt
LPAR3	Genes_SelectbyRFEofFeatureData_expr_label_cluster 20 .txt
GPSM2	Genes_SelectbyRFEofFeatureData_expr_label_cluster 20 .txt
NPY2R	Genes_SelectbyRFEofFeatureData_expr_label_cluster 20 .txt
GNAT3	Genes_SelectbyRFEofFeatureData_expr_label_cluster 20 .txt
ADRB2	Genes_SelectbyRFEofFeatureData_expr_label_cluster 20 .txt
GHSR	Genes_SelectbyRFEofFeatureData_expr_label_cluster 20 .txt
TSHR	Genes_SelectbyRFEofFeatureData_expr_label_cluster 20 .txt
AGTR1	Genes_SelectbyRFEofFeatureData_expr_label_cluster 20 .txt
RGS16	Genes_SelectbyRFEofFeatureData_expr_label_cluster 20 .txt
TTC1	Genes_SelectbyRFEofFeatureData_expr_label_cluster 20 .txt
GNGT1	Genes_SelectbyRFEofFeatureData_expr_label_cluster 20 .txt
GNAS	Genes_SelectbyRFEofFeatureData_expr_label_cluster 20 .txt
TFAP2A	Genes_SelectbyRFEofFeatureData_expr_label_cluster 3 .txt
SERPINB8	Genes_SelectbyRFEofFeatureData_expr_label_cluster 3 .txt
LDLRAP1	Genes_SelectbyRFEofFeatureData_expr_label_cluster 3 .txt
MAP3K2	Genes_SelectbyRFEofFeatureData_expr_label_cluster 3 .txt
SORL1	Genes_SelectbyRFEofFeatureData_expr_label_cluster 3 .txt
ACAN	Genes_SelectbyRFEofFeatureData_expr_label_cluster 3 .txt
FGF13	Genes_SelectbyRFEofFeatureData_expr_label_cluster 3 .txt
STYXL1	Genes_SelectbyRFEofFeatureData_expr_label_cluster 3 .txt
DPP4	Genes_SelectbyRFEofFeatureData_expr_label_cluster 3 .txt
GPC3	Genes_SelectbyRFEofFeatureData_expr_label_cluster 3 .txt
ZNF8	Genes_SelectbyRFEofFeatureData_expr_label_cluster 3 .txt
ECM1	Genes_SelectbyRFEofFeatureData_expr_label_cluster 3 .txt
SRPRB	Genes_SelectbyRFEofFeatureData_expr_label_cluster 3 .txt
SDC4	Genes_SelectbyRFEofFeatureData_expr_label_cluster 3 .txt
MATN2	Genes_SelectbyRFEofFeatureData_expr_label_cluster 3 .txt
KCNB1	Genes_SelectbyRFEofFeatureData_expr_label_cluster 4 .txt
ARHGAP32	Genes_SelectbyRFEofFeatureData_expr_label_cluster 4 .txt
EIF2AK1	Genes_SelectbyRFEofFeatureData_expr_label_cluster 4 .txt
ATG16L1	Genes_SelectbyRFEofFeatureData_expr_label_cluster 4 .txt
MEGF10	Genes_SelectbyRFEofFeatureData_expr_label_cluster 4 .txt
CDK14	Genes_SelectbyRFEofFeatureData_expr_label_cluster 4 .txt
CDK17	Genes_SelectbyRFEofFeatureData_expr_label_cluster 4 .txt
DYNC1I1	Genes_SelectbyRFEofFeatureData_expr_label_cluster 5 .txt
PTPRJ	Genes_SelectbyRFEofFeatureData_expr_label_cluster 5 .txt
VPREB1	Genes_SelectbyRFEofFeatureData_expr_label_cluster 5 .txt
DNAAF5	Genes_SelectbyRFEofFeatureData_expr_label_cluster 5 .txt
SCAF11	Genes_SelectbyRFEofFeatureData_expr_label_cluster 5 .txt
EFNA4	Genes_SelectbyRFEofFeatureData_expr_label_cluster 5 .txt
GOLM1	Genes_SelectbyRFEofFeatureData_expr_label_cluster 5 .txt
KLRC3	Genes_SelectbyRFEofFeatureData_expr_label_cluster 5 .txt
PPP5C	Genes_SelectbyRFEofFeatureData_expr_label_cluster 6 .txt
SPTA1	Genes_SelectbyRFEofFeatureData_expr_label_cluster 6 .txt
RNF138	Genes_SelectbyRFEofFeatureData_expr_label_cluster 6 .txt
MAP2	Genes_SelectbyRFEofFeatureData_expr_label_cluster 6 .txt
PRPH2	Genes_SelectbyRFEofFeatureData_expr_label_cluster 6 .txt
PCBP4	Genes_SelectbyRFEofFeatureData_expr_label_cluster 6 .txt
SGO2	Genes_SelectbyRFEofFeatureData_expr_label_cluster 6 .txt
METAP2	Genes_SelectbyRFEofFeatureData_expr_label_cluster 6 .txt
TJP1	Genes_SelectbyRFEofFeatureData_expr_label_cluster 6 .txt
CSE1L	Genes_SelectbyRFEofFeatureData_expr_label_cluster 6 .txt
SLC25A23	Genes_SelectbyRFEofFeatureData_expr_label_cluster 6 .txt
SET	Genes_SelectbyRFEofFeatureData_expr_label_cluster 6 .txt
EXOC5	Genes_SelectbyRFEofFeatureData_expr_label_cluster 6 .txt
CELF3	Genes_SelectbyRFEofFeatureData_expr_label_cluster 6 .txt
GJA3	Genes_SelectbyRFEofFeatureData_expr_label_cluster 6 .txt
TOP2A	Genes_SelectbyRFEofFeatureData_expr_label_cluster 6 .txt
RNMT	Genes_SelectbyRFEofFeatureData_expr_label_cluster 6 .txt
LMNB1	Genes_SelectbyRFEofFeatureData_expr_label_cluster 6 .txt
ESR2	Genes_SelectbyRFEofFeatureData_expr_label_cluster 6 .txt
SPTB	Genes_SelectbyRFEofFeatureData_expr_label_cluster 6 .txt
ANAPC4	Genes_SelectbyRFEofFeatureData_expr_label_cluster 6 .txt
CDH1	Genes_SelectbyRFEofFeatureData_expr_label_cluster 6 .txt
PLEC	Genes_SelectbyRFEofFeatureData_expr_label_cluster 6 .txt
RBFOX1	Genes_SelectbyRFEofFeatureData_expr_label_cluster 6 .txt
TOP2B	Genes_SelectbyRFEofFeatureData_expr_label_cluster 6 .txt
KPNA4	Genes_SelectbyRFEofFeatureData_expr_label_cluster 6 .txt
RBFOX2	Genes_SelectbyRFEofFeatureData_expr_label_cluster 6 .txt
CBLL1	Genes_SelectbyRFEofFeatureData_expr_label_cluster 6 .txt
LZTS2	Genes_SelectbyRFEofFeatureData_expr_label_cluster 6 .txt
CDC26	Genes_SelectbyRFEofFeatureData_expr_label_cluster 6 .txt
KPNA6	Genes_SelectbyRFEofFeatureData_expr_label_cluster 6 .txt
PRKCG	Genes_SelectbyRFEofFeatureData_expr_label_cluster 6 .txt
EXOC1	Genes_SelectbyRFEofFeatureData_expr_label_cluster 6 .txt
PTPN14	Genes_SelectbyRFEofFeatureData_expr_label_cluster 6 .txt
AFAP1	Genes_SelectbyRFEofFeatureData_expr_label_cluster 6 .txt
GZMA	Genes_SelectbyRFEofFeatureData_expr_label_cluster 6 .txt
EPAS1	Genes_SelectbyRFEofFeatureData_expr_label_cluster 7 .txt
HERC6	Genes_SelectbyRFEofFeatureData_expr_label_cluster 7 .txt
MRM3	Genes_SelectbyRFEofFeatureData_expr_label_cluster 7 .txt
UBOX5	Genes_SelectbyRFEofFeatureData_expr_label_cluster 7 .txt
SYVN1	Genes_SelectbyRFEofFeatureData_expr_label_cluster 7 .txt
FBXW11	Genes_SelectbyRFEofFeatureData_expr_label_cluster 7 .txt
BBS1	Genes_SelectbyRFEofFeatureData_expr_label_cluster 7 .txt
UBE2U	Genes_SelectbyRFEofFeatureData_expr_label_cluster 7 .txt
UBR1	Genes_SelectbyRFEofFeatureData_expr_label_cluster 7 .txt
CDC34	Genes_SelectbyRFEofFeatureData_expr_label_cluster 7 .txt
TNNC2	Genes_SelectbyRFEofFeatureData_expr_label_cluster 8 .txt
ING3	Genes_SelectbyRFEofFeatureData_expr_label_cluster 8 .txt
TNNT1	Genes_SelectbyRFEofFeatureData_expr_label_cluster 8 .txt
TCAP	Genes_SelectbyRFEofFeatureData_expr_label_cluster 8 .txt
TNNT2	Genes_SelectbyRFEofFeatureData_expr_label_cluster 8 .txt
OBSCN	Genes_SelectbyRFEofFeatureData_expr_label_cluster 8 .txt
GRIA2	Genes_SelectbyRFEofFeatureData_expr_label_cluster 9 .txt
GYS1	Genes_SelectbyRFEofFeatureData_expr_label_cluster 9 .txt
WT1	Genes_SelectbyRFEofFeatureData_expr_label_cluster 9 .txt
RASGRF1	Genes_SelectbyRFEofFeatureData_expr_label_cluster 9 .txt
HNRNPUL1	Genes_SelectbyRFEofFeatureData_expr_label_cluster 9 .txt
LIPE	Genes_SelectbyRFEofFeatureData_expr_label_cluster 9 .txt
KHDRBS3	Genes_SelectbyRFEofFeatureData_expr_label_cluster 9 .txt
PPP1CB	Genes_SelectbyRFEofFeatureData_expr_label_cluster 9 .txt
GRIK2	Genes_SelectbyRFEofFeatureData_expr_label_cluster 9 .txt
GRIA1	Genes_SelectbyRFEofFeatureData_expr_label_cluster 9 .txt
HAUS2	Genes_SelectbyRFEofFeatureData_expr_label_cluster 9 .txt
TAF15	Genes_SelectbyRFEofFeatureData_expr_label_cluster 9 .txt
TK1	Genes_SelectbyRFEofFeatureData_expr_label_cluster 9 .txt
SF1	Genes_SelectbyRFEofFeatureData_expr_label_cluster 9 .txt
USP8	Genes_SelectbyRFEofFeatureData_expr_label_cluster 9 .txt
DDX17	Genes_SelectbyRFEofFeatureData_expr_label_cluster 9 .txt
LASP1	Genes_SelectbyRFEofFeatureData_expr_label_cluster 9 .txt
CEP72	Genes_SelectbyRFEofFeatureData_expr_label_cluster 9 .txt
STOM	Genes_SelectbyRFEofFeatureData_expr_label_cluster 9 .txt
